########
#      #
# @    #
#  $  .#
#  $  .#
########
Author: François VION.

Done