#######
#  .$ #
#$..$ #
#..$$ #
#.$$. #
#.$@  #
#######
Title: DYSKONEKTED
Collection: SOKOSTATION
Date: 2012-11-28
Author: Ghislain MARTIN
AuthorMail: sokoban@orange.fr
AuthorPage: www.sokoban.fr
